Sean -> Danielle
Winnie -> Andrea
Brian -> Priscilla
Amy -> Anna
Samir -> Gabriel
Joe -> Anderson
Bethany -> Leo
Bruno -> Regis
Anna -> Bethany
Matthew -> Marina
Lucas -> Cinthia
Gabriel -> Julianna
Martha -> Mary
Philip -> Brian
Andre -> Paula
Danielle -> Arthur
Leo -> Sean
Cinthia -> Alex
Paula -> Joe
Mary -> Lucas
Jane -> Martha
Anderson -> Philip
Priscilla -> Bruno
Regis -> Samir
Julianna -> Winnie
Arthur -> Mark
Mark -> Andre
Marina -> Jane
Alex -> Matthew
Andrea -> Amy